25 19
100 100
200 200
3 3 3 3 3 3 3 3 3 3 3 3 3 3 3 3 3 3 3 3 3 3 3 3 3
3 3 3 3 3 3 3 3 3 3 3 3 3 3 3 3 3 3 3 3 3 3 3 3 3
3 3 0 0 0 0 1 1 1 1 1 2 5 5 5 0 1 1 1 1 1 1 1 3 3
3 3 0 0 0 0 1 4 0 0 1 0 0 0 5 0 1 0 5 5 5 5 5 3 3 
3 3 1 1 1 1 1 0 0 0 1 0 0 0 0 0 1 4 5 5 0 5 5 3 3
3 3 5 5 0 0 0 0 0 0 1 0 0 5 5 0 1 1 1 1 0 0 0 3 3 
3 3 5 5 5 1 1 1 1 1 1 0 0 5 5 0 0 0 0 1 4 0 0 3 3 
3 3 5 0 0 1 0 0 0 5 5 5 5 5 5 0 4 1 1 1 1 1 1 1 3 
3 1 1 1 1 1 0 0 0 0 0 5 5 5 0 0 1 1 0 0 0 5 5 3 3 
3 1 1 1 1 1 1 1 1 1 1 1 1 1 0 0 1 0 0 0 0 5 5 3 3 
3 3 0 0 1 0 4 0 0 0 0 0 4 1 1 1 1 0 0 0 5 5 0 3 3 
3 3 5 5 1 0 0 0 5 5 5 0 0 0 0 0 1 0 0 0 0 0 0 3 3 
3 3 5 5 1 0 0 5 5 5 5 5 5 5 0 0 1 0 0 0 0 0 0 3 3 
3 3 5 5 1 0 0 0 0 5 5 5 5 5 5 0 1 1 1 1 1 1 1 1 3 
3 3 5 5 1 1 1 1 1 4 0 0 5 0 0 0 1 4 0 0 4 1 1 1 3 
3 3 0 5 5 5 0 0 1 1 0 0 0 0 0 0 0 0 0 5 0 0 0 3 3 
3 3 0 0 0 0 0 0 0 2 1 1 1 1 1 1 0 0 0 5 5 5 5 3 3 
3 3 3 3 3 3 3 3 3 3 3 3 3 3 3 3 3 3 3 3 3 3 3 3 3 
3 3 3 3 3 3 3 3 3 3 3 3 3 3 3 3 3 3 3 3 3 3 3 3 3
