25 19
100 100
200 200
3 3 3 3 3 3 3 3 3 3 3 3 3 3 3 3 3 3 3 3 3 3 3 3 3 
3 3 3 3 3 3 3 3 3 3 3 3 3 3 3 3 3 3 3 6 3 3 3 3 3 
6 1 1 1 1 1 1 1 1 1 1 1 1 1 4 1 1 1 1 0 0 5 0 3 3 
6 2 5 5 0 0 1 0 0 0 0 1 1 1 5 5 5 1 1 0 5 5 5 3 3 
6 5 5 5 5 0 4 0 0 0 0 0 0 0 5 6 6 5 0 0 0 6 1 3 3 
6 5 1 1 0 6 6 6 0 0 0 0 0 0 5 5 5 5 0 0 0 4 1 3 3 
6 0 1 1 0 0 6 6 0 0 0 1 1 1 1 1 1 1 0 0 0 1 1 3 3 
6 0 1 1 1 0 0 0 0 5 5 1 1 1 1 6 6 1 1 0 0 1 1 3 3 
6 0 1 1 1 0 0 0 0 5 5 1 1 1 1 6 6 1 1 0 0 1 1 3 3 
6 1 1 1 1 4 5 5 5 5 5 5 5 5 5 6 6 1 1 0 0 1 1 3 3 
6 0 0 0 5 1 1 1 1 1 1 1 6 1 1 4 6 1 1 0 6 6 1 3 3 
6 0 0 0 5 1 1 1 6 6 6 1 1 0 1 1 1 1 1 1 6 6 1 3 3 
6 0 0 0 5 5 1 1 1 1 6 1 1 0 0 1 0 0 0 0 0 0 1 3 3 
6 0 0 0 5 5 5 1 1 1 0 0 5 5 5 5 0 0 0 0 0 0 1 3 3 
6 1 1 1 1 0 0 1 1 1 0 5 1 1 4 5 5 5 1 1 1 1 1 3 3 
6 1 1 1 4 0 0 1 1 1 0 1 1 1 1 1 1 1 1 1 1 1 1 3 3 
6 1 1 6 6 0 0 0 0 0 0 1 1 1 1 1 1 1 6 6 6 1 1 3 3 
3 3 3 6 6 3 3 3 3 3 3 3 3 3 3 3 3 3 3 3 3 3 3 3 3 
3 3 3 3 3 3 3 3 3 3 3 3 3 3 3 3 3 3 3 3 3 3 3 3 3
