25 19
100 100
200 200
3 3 3 3 3 3 3 3 3 3 3 3 3 3 3 3 3 3 3 3 3 3 3 3 3 
3 3 3 3 3 3 3 3 3 3 3 3 3 3 3 3 3 3 3 3 3 3 3 3 3 
3 3 7 7 7 0 0 0 0 0 1 4 7 7 7 7 7 7 7 7 7 7 7 3 3 
3 3 7 7 7 2 0 0 0 0 1 0 7 7 7 7 7 7 7 7 7 7 7 3 3 
3 3 7 7 1 1 1 1 1 0 1 0 0 0 0 5 5 5 5 0 2 0 0 3 3 
3 3 0 0 0 4 1 0 1 1 1 1 0 0 0 1 1 1 1 1 1 1 0 3 3 
3 3 0 0 0 1 1 0 0 0 4 1 1 0 0 1 0 0 7 7 0 1 4 3 3 
3 3 1 1 1 1 1 5 0 0 0 0 1 5 0 1 0 7 7 7 0 1 1 3 3 
3 3 1 1 1 1 1 5 7 7 7 7 1 5 0 1 0 7 7 7 0 1 1 3 3 
3 3 0 0 1 5 5 5 7 7 7 7 1 5 0 1 4 0 0 0 0 0 0 3 3 
3 3 0 0 1 1 1 1 0 0 0 0 1 5 0 1 1 1 1 0 0 0 0 3 3 
3 3 0 0 0 0 4 1 2 0 0 0 1 1 1 1 0 0 1 1 1 0 0 3 3 
3 3 1 1 1 1 1 1 1 1 1 1 1 1 5 5 0 0 0 0 1 2 0 3 3 
3 3 5 5 5 5 5 0 0 0 0 1 1 1 5 5 7 7 7 0 1 1 1 3 3 
3 3 7 7 7 0 0 0 0 0 0 1 4 1 1 5 7 7 7 0 1 0 0 3 3 
3 3 7 7 7 0 0 0 1 1 1 1 0 0 1 1 2 0 0 0 1 0 0 3 3 
3 3 7 7 7 0 0 0 1 1 0 0 0 0 0 1 1 1 1 1 1 4 0 3 3 
3 3 3 3 3 3 3 3 3 3 3 3 3 3 3 3 3 3 3 3 3 3 3 3 3 
3 3 3 3 3 3 3 3 3 3 3 3 3 3 3 3 3 3 3 3 3 3 3 3 3

